1:34
 BBPP  B BP P   B
  B PP   PPB P  P
         BBP P  P
         BBP P  P
 P              B
PB       BBP P  P
PB PP  B BD P   B
BB PP  B BP P   B
 B PP  B BP P   B
 PP           B B